#################################################################################################################################################################################################################################
#S#   #             #             # #               #       #         #       #   #           #     #     #   #         #             #         #               #             #           #         #   #       #         # #   #
# # # # # ######### ##### ####### # # ####### ##### # ##### # ##### # ### ### # # # ######### # ### ### # # ### # ##### ##### ######### ##### # ########### # ### ######### ### ######### # ##### # # # # ### ### ### ### # # # #
#   # # # #       #     # # #     #   #     #     # # #   #       # #     # #   #   #   #     # # #     # # #   #   # #   #   #   #     #     #             # #   #     # #     #       #   #   # # # # #   # #   # # # # #   # #
##### ### ### ### ##### # # # ##### ##### ####### # ### # ######### ####### ######### # # ##### # ####### # # ##### # ### # # # # # ##### ##### ############### ### ### # ########### # ##### ### # # # ### ### ### # # # ##### #
#   #     #   # # #   #   #   #         #       # # #   #       #   #                 # #   #   #   #     #     # # #     # # # # #   # # #     #             # #   #   #     #       #   #   #   #   #     #   #   # #         #
# ######### ### # # # ##### ### ####### ### # # # # # ######### # ############# # ##### ### # ### # # ######### # # ### ### ### # ### # # ####### ########### # # # ### # ### ### ####### # # # ####### ##### ##### # ######### #
# #     #   #       #   #   #   #     #   # # # # # # #       # #             # #     #   # # #   # # #     #     #   #   #     # #   # #       #         #   # # #   # #   #   #   #   # # # # #     # #   # #   # # #   #     #
# # ### # # # ######### # ####### ### ### ### ### # # # # ### # ##### ####### ##### # ##### # # ### # # ### ######### ### ####### # ### ####### ##### ##### # # ##### # ### ### ### # ### # ### # ### ### # # # # # # # # #######
#   # #   # # #   #     #         #   # #     #   # # # #   # #     #   #   #     # #     # # # # #   #   #     #   #   # #     #   #       #   #   # #     # #       #   # # #     #     # #   #   #   # #     #   #   #       #
# ### ##### ### # ### ############# ### # ##### ### # ### # ####### ##### # ##### ### ### # # # # ####### ##### # # ### # # ### # ### ##### # ### # # # ##### ########### # # ####### ##### # ##### ### # ######### ########### #
# #       # #   #   # #       #   #   #   #     #   #   # #       # #     #     #   #   #     #   #     # #   # # # #   # # #   # #     #   #     #   #     #     #     #   #     #   #     # #   #   #   #   #   #     #     # #
# ##### # # # ##### ### ##### # # ### ##### ##### ##### # ### ### # # ######### # # ############# # ### # # ### # # # ### # # ### ##### # # ############### ##### ##### ##### ### # ### ### # # # ### ##### # # # ##### ### # # #
#     # # #   #   # #   #   # # #   #       #   # #     #   #   # #   # #       # #           #   # #     #     # #   #     #   #   #   # # #       #     # #   #   #       # #   # #   #   # # #       #   #   # #   #     # # #
##### # ####### # # # ##### # # ### ######### ### # ########### # ##### # ####### ########### ### # ####### ##### ############# ### # ### ### ### ### ### # # ##### # ##### # ##### # ### ### # ######### ####### # # ######### #
# #   #         # # # #     # # #     #         # # #         # #   #   #   #   #     #     #   # #     # #     #     #   #     #   #   #   # # #     #   # # #       #   #   #   # #   # #   # #   #     #     # # #   #   #   #
# # ######### ### # # # ### # # # # ### ####### # # # ####### # ### ### ### # # ##### ##### ### # ##### # ##### # ### # # ### ### ##### ### # # ####### # # # # ####### # ### # # # ##### # ### # # # ##### ##### # ### # # # # #
# # #   #     #   # #   #   # # # # #   # #     #   #     # #   #         # # #   #         #   #     # #     # #   #   #   # # # #   # #   # #     #   # # # # #   #   #   # # #   #   # #   # # # #   #     #   # #     #   # #
# # # # # ### ##### ##### ### # # ### ### # ########### # # # ############# # ### ########### ####### # ##### # ### ####### # # # # # # # ### ##### # ##### # # # # # ##### ### ##### # # ### # ### ### ##### # ### #############
# # # #   #   #         #   #   #   #     #           # # #   #     #     # #   # #       #   #     #   #     #   # #     # # #     # # #   # #     #   #   #     # # #   #     #   # #     #   #   #   #   #     #             #
# # # ##### ### ####### ### ####### ##### ####### ### ### ##### ### # ### # ### # # ##### # ### ######### ### ### ### ### # # ####### # ### # # # ##### # ######### # ### ####### # # ##### ##### ### # # # ##### # ########### #
#   # #     # #       #   #   # #   #   # #     #   #     #     #   #   #   #   #   #     #   # #         # #   # #   # #   #       # #   #     # #     #   #   # # #         #   #   #   # #     #   # # #   #   #     #       #
# ### ### ### ####### ####### # # # # ### # ### ### ####### ##### # ### ##### ####### ##### # # # ### ##### ### # # ### ########### # # ######### # ####### # # # # ######### ### ##### # # # ##### ##### ### # ######### ##### #
#   #   #           # #       # # #   #   # #     #           #   # # # #     #     # #   # # #     #   #     # #   #       #     # # # #   #     #     #   # # #   #   #     #   # #   # # #   #   #       # #       #   #   # #
### ### ########### # # ####### # ##### ### ################# # ### # # # ##### ##### # # ### ##### ### ### # # ##### ####### ### # # ### # # ######### # ### # ##### # # ##### ### # # ### ### # # # ####### ####### # ### # # #
# #     #           #       #   # #     #     #       #     # #   #   #   #   #     #   #   #   #   #   #   # #     #       #   #   #   # # # #   #     #     #       # # #   # #   # #         # # #   #     #     # # #   # # #
# ####### ################# # ### # ##### ### # ### ### ### ##### ### ##### # # ### ####### ### ##### ### ######### # ##### ### ####### # # # ### # ################### # # # # ### # ##### ##### ##### # ##### ### # # ### # # #
#   # #   # #     #       #   #   # #       #     # #   #         # # #     # # # #     # #   #     #   #       #   # #     #   #   #     # #     # #   #       #     # #   # #   #   #   # #     #     #     # # #   #   # #   #
# # # # ### # ### # ##### ##### # # # ####### ##### # ############# # # ### # # # # ### # ### # ### # # ### # ### ### # # ### ### # ####### ####### # # # ### # ##### # ##### ### ##### # ### ##### ######### # # ####### # #####
# #   # #   # #     #   #   #   # # #   #   #   #   #     #       # # # #   # #   #   #     # # # # # #   # #   #   # # # #   #   #   # #   #     #   # # # # #       #     #   #   #   # #   #     #       # #     #     # #   #
# ### # # # # ####### ##### # ### # ##### # ##### ####### # # ### # # ### ### ### ### ##### # # # # ##### ##### ### # # ### ### ##### # # ### ### # ### # # # ####### ### ##### # # # ### # ### ##### ### # # ##### ### ### # # #
# #   #   # #       # #     # #   #     # #     #     #   # # #   # #     # #   # #   # #   # # # #     # #   #   # # # #   #   #   # #     # #   # # # #   # #     #   #     # # #   # # #   # #     #   # # #   #     # # # # #
# # ####### ####### # # ##### # ####### # ##### ### ### ##### # ### ####### ### ### ### # ### # # ##### # # # ### # ### # ##### # # # ##### # # ### # # ### # ##### ### ##### # # ##### # ### # ### ### ### # # # ####### # ### #
# # #       #       # # #     #   #   # # #     #   #   #     #     #         #     # #   # # #   #   # #   #   #   #   #     #   # #     #   #   # # #   # # #   # #   #   #   #       # #   #   # #   #   #   #   #     #     #
# ### ####### ####### # ### ##### ### # # # ##### ### ### # ######### ### ### ####### # ### # ##### # # # ##### # ### ####### ##### ##### ####### # # # # # # # # # # ### ########### ### # ##### ### ### ######### # ### ##### #
#   #     # # #       # #   # #       #   # #       #   # #             # #           #     #     # #   # #     # #   #       #   # #   #   # #   #   # # # #   # #       #     #     #   # #   #     # # #   #     #   #   #   #
# # ##### # # # ### ### # ### # ##### ##### # ##### ### ############### # # ############### ##### # ####### ##### # ### ####### # # # # ### # # ##### # ### ##### ######### # ### ##### ### # # ####### # # # # ##### # ##### ###
# # #     # # #   #   #   #   # #   # #   # # #       #     #     #   # # # #   #   #       # #   # #       #     #   #     #   # # # #   # # #   # # #         #   #     # #     #   #   #   #         # # #   #   # # #     # #
### # ##### # ####### # ##### # # # ### # # # # # ######### # ### # # ### # # # # # # ####### # ### ### # ### ####### ##### ### # # ##### # # ### # # ########### # # ### # ####### # ### ########### ### # ####### # # # ##### #
#   # #   # #       #   #   # # # #     # # # # # #         #   #   #   # # # #   #   #   #   #   #   # # # #         #   #     # #   #   # #   # #   #     #   # #   # #   #       #             # #     #   #   #   #       # #
# ### # # # ####### # ### # # # # ####### # ### # # ####### ### ####### # ### ######### # ### ### # # # # # ######### # # ####### ### # ### # # # # ##### # # # # ##### ##### ################### # ######### # # ########### # #
#   # # # #     #   #   # # #   #   #     #     # #     #   #   #     # #     #         #     #   # # # # #   #     # # #       #     #   # # #   #       # # # #     #   # #   #     #         # # #       #   #           #   #
### # # # ##### # ### ### # # ### ### ########### ##### # ### ### # # # # ########### ####### # ##### # # # # # ### # # ####### ######### # # ########### ### # ##### # # # ### # # # # ##### ### # # ##### ############### ### #
#   # # #   #   #   # #   # #   # #   #     #     #   # #   # #   # # # # #           #     # # #     # # # # # #   # #   #   #     #     # #         # # #   # # #     #     # # # # #     #     # #     #     #   #     #   # #
# ### # ### # ##### # # ### ##### # # # ### # ####### # ### # ##### # # # ### # ####### ##### # # ##### # # # # # ### ### # # ### # # ##### ######### # # # ### # # ########### ### # ##### ####### ##### ### ### # # ### ### # #
#     # # # #     # # # # # #     # # # #   # #       #   # #       # # #   # # #   #       # # # #     # # #   #     #   # #   # # #   #   #       # #   # #   #     #   #   #   # #     # #       #     # #   # #   # #   # # #
# ##### # # ### # # # # # # # ##### ### # ### ### ####### # ######### # ### # # # # ####### # # # ####### ##### ####### ### ### # # ### # ### ### ### # ### # ######### # # # ### # ##### # # ### ### ##### ### # ##### ### # # #
#     # #       # # # #   #     #   #   #   #   #   #     # #     #   #   #   # # #       #   #   #       #   #   #     #   #   # #     #   #   #   # # #   #         # #   #     #   #   # # # #     #       # #     #       # #
##### # ######### # ##### ####### ### ##### ### ### # ##### ### ### ##### ####### ####### ######### ##### # # ##### ##### ### ### ######### # ##### # # # ########### # ########### # # ### # # ############# # ##### ###########
# #   #   # #     #     # #       #   #   #   #   # #   #       #   #   #         # #     #       # # #   # # #     #       #   #           # #     # # # #     #   # #   #       # # #   # #                 #     #       #   #
# # ##### # # ######### # # ####### ### # ### ### # ### ######### ### # ########### # ### # ### # # # # ### # # ##### ##### ### ############# # ### # ### # ### # # # ### ### ### # # ##### ################# ### ######### # # #
# # #   # #   #   #     # # #       # # #   #         #         # #   # #           #   # # #   #   #   #   # # #         # #   #     #       #   # #   #     # # # #   #   #   #   #     #     #   #     #     #         #   # #
# # # # # # ### # # ### # # # ####### # ### ### ##### ######### # # ### # ### ### ##### ### # ####### ### ### # # ####### # ##### ### # ######### # ### ####### # ##### ### ####### ##### ##### # # # ### ####### ### ### ##### #
# #   # # #   # #   #   # # # #       # #     # #   #   #   #   #   # # # #   # # #     #   # #     # #   #   # # #     # #     #   #   #     #   #   # #       #     #     #     #   # #     #   # #   #       # # # #       # #
# ##### # ##### ##### ### # # # ##### # ##### ### # # ### # # ####### # # # ### # # # ### ### # ##### # ### ### ### ### ##### # ### ##### ### # ### ### # ######### ####### # ### ### # ### # ##### # # ####### # # # ######### #
#   #   #   #   #       # #   # #   # #     #   # # # #   # #   #   #   # # # #   # # #   # # #     # # #   #   #   #   #   # #         #   #   #   #     #         #     # # # #   #     # # #   # # # # #     #   #   #   #   #
# # # ##### # ### ##### # ##### # # ####### ### # # # # ### ### # # # ##### # # ### # # ### # ##### # # # ### ### ### ### # ### ####### ### ######### ####### ##### # ### # # # ### ##### # # # # # ### # # ####### ### # # # ###
# # # #   # # #   #   # # # #     #       # #   # # # # #       # # #       #   # # # #     #     #   # #     #   # #     #   #   #   #   #           #     # #     #   # # # #   #     # # # # # #     # #       #   #   # #   #
### # # # # # ##### # ### # # ########### # # ### # ### ######### # ######### ### # # ##### ##### # ### ####### ### ######### # ### # ##### ########### ### # ##### ### # # # ### ##### ### ### # ####### ####### ### ##### ### #
#   # # #   #       #     #   #     # #   # #     #   #     #     #     #     #   # # #   #   #   #   # #   #   #       #   # # #   #     # # #       # #   #     #   # # # #   #   # #   # #   #             #   #     #   #   #
# # # # ### ################# # ### # # # # ######### ##### # ##### ##### ##### # # # # # ### # ##### # # # # ####### # # # # # # ####### # # # ##### # # ####### ### # # # ### # # # ### # # ############# # # ######### ### # #
# # # # # #       #         #   # # # # # # #               #     #   #   #     # # # # # #   #   #   #   #   #     # #   # # # # #     # #   #   # #   # #     #   # # # #   # # #     # #   #     #       # #       #   #   # #
# # # # # ####### ##### ### ##### # # # # # ##### ############### ### # ####### ### # # # # ##### ### ######### ### ####### # # # ##### # ### ### # ##### ### # # # ### # # ### # ####### ##### ### # # ############# # # # ### #
# # #   #       #       # #     # # # # # #     #   #     #     # # # #       #   # # # #   #   #   # #   #     #   #       # # #   #   #   # # # #     #     # # #     #   #   #     #   #   # #     # #       #       # # # # #
# ########### # ######### ##### # # # # ####### ### # ### # ### # # # ####### ### # ### ##### # ### # # # # ##### ### ##### # ##### # ##### # # # ### # ####### # ######### # ####### # ### # # # ####### ##### # ######### # # #
# #         # #         #     # # #   #       #   # #   #   # #   # #   #   # #   #     #     #   # #   #   #         #     #   #   #     # #   #   # #       # #   #     # # #   #   # #   #   # #   #   #   #     #       # # #
# # # ##### ######### ### ### # # ### ### ### ### ##### ##### ##### # ### # # # ############### # # ####### ######### ######### # ####### # ### ### ### ##### # ##### ### ### # # # # # # ######### # # ### # ####### ####### # #
#   #   #           #   #   #   # #   # #   #   #     #   #         #     #   #   #       #     # #   #     #       # #       # #       #   #     #   #   #   #   #   #     #   # # # # #     #     #       #   #     #     #   #
####### # ######### ### ### ##### # ### ### ### ##### ### # ####### ########### # # ### # # ##### ### ##### # ##### ### ##### # ####### # ########### ### # ##### # ####### # ### # ### # ### # ########### ##### ##### ### # ###
#       #   #   # #       #   #           # # #     #     #   #   #           # # # # # # # #     #   #   # # #   #   # #   #   #     # #     #       #   #     # #       # #   # #     #   #   #     #   # #     # #     # # # #
# ##### ##### # # ####### ### ######### ### # ##### ########### # ### ##### # # # # # # # # ####### ### # # # ### ### # # # ##### ### # ##### # ####### ####### # ####### # ### # ### ##### ##### ### # # ### ##### # ### ### # #
#   #   #     # #       # # #       #   #   #     #   #     #   #   # #   # # # #   # # #   #     #     # # #     #   # # #     #   #   #     # #   #       # #   #       # #   #   # #   #   #   # # # #     #   #   # #     # #
### # ### ##### ### ### # # ####### ##### ### ####### ### # # ##### # # # # # # ##### # ### # ### ####### # ##### # ### # ##### # # ##### ##### # # ####### # ##### ####### ####### # ### ### # ### # # ####### # # ### ####### #
#   #   # #   #   #   # #       #   #     #         # #   #   #   # # # #   # #     # #   # #   #         #   #   #   # # #   #   #   # # #     # #     #           #     #         #   #   # # #     # #     # #   #           #
# ####### # # ### # # # ####### # ### ########### # # # ######### # ### # ######### # ### ##### ############# # ##### # # # # ####### # # ### ### ##### ################# ############# # ### # # ##### ##### # ##### ####### # #
# #       # # #   # # # #       # #             # # #   #   #     # #   # #       # # #   #   #       #       #   #   # #   # #       # #   #     #   #     #     #     #     #       # #     # #       #   # # #         #   # #
# # ####### # # ### # # # ####### # ####### ### ### ### # # # # ### # ##### ### ### # # ### # ####### ##### ##### # ### ##### # ####### ### # ##### # ##### # ### # ### ### # # ### # # ### ### ######### # # # # ######### ### #
# #   #   # #   #   # # #   #   # #   #   #   #   #     # # # # #   #         #   # # #   # #       # #   # #   # #     #     # #   #       #     # #     # # # #     #   # # #   # # #   #   # #   #     # # # #   # #     #   #
# ### # ### ##### ### # ### # # # ##### # ### ### ####### # ### # ### ########### # # ### # ####### # # # ### # # ############# # # # ########### # ### ### # # ######### # # ##### # ### ### # ### # ### # # # ### # # # ##### #
#   # #   # #   #   # #   # # # #   #   # #   # # #     # #   # # #   #     #     # # #   #   #     #   #     # # # #         # # #   #     #   # #   # #   #   #   #     # #   #   # # #   # # #   # #   #   # #   # # # #   # #
### # # # # # # ### # # ### ### ### # ### ### # # # ### # ### # # # ### ### # ##### # # ### ### ### ########### # # # ### ### # # ####### # # # # ##### # ##### # ### ##### ### # ### # ### ### # ### # # ##### # ### # ### # # #
#   # # # # # #     # # #         # #   #   #   #     #   #   #   #   #   # #         #     #   # #   #     #   # #     # # #   # # #     #   # #   #   #     #   #   #     # #   # # #   #     #     # # #     # #   #     # # #
# # # # # # # ####### # # ######### ### ### ############# # ### ##### ##### ##### ######### # ### ### # ### # ### # ##### # ##### # # # ####### ### # # ##### ### # ### ### # ##### # # # ####### ##### ### ##### # # ####### # #
# # # # # # #   #   # # # # #     #   # # #         #   # # # # #           #   #   #     # #   #     #   # #     # #   # # #   # #   #   #   #   #   #   # #   # # #     # #   #     # #       # #   #     # #     # #     # # #
# # # ### # ### # ### # # # # ### ### # # ######### # # ### # # ########### # # ##### ### ##### # ##### ### ####### # # # # # # # ####### # ##### ####### # # ### # ### ### # # # ####### ##### # # # ####### # ##### ### # # ###
# # #   # # #     #   # # # #   #   # # #             #     # #       #     # #     # # #   #   # #   # #   # #     # #   #   # # #   #   #       #   #     # #   #   # #   # # # #       #   # # # #   #       #   #     # #   #
# ##### # # ####### ##### # ### ### # # ##################### ####### ####### ##### # # ### # ### # # ### # # # ##### ##### ### # # # # ### ####### # ####### # ##### ### ### ### # ######### # # # # # # ####### # ####### ### #
#     # # #       #       # #   # #   #               #           # #   #   #   # # # # #   # # # # #     #   # # #   #     # # # # #   # # # #     # #     # # #   # #   #       # #   #   #   # # # # #     #   # #     # # # #
# ### # # ####### # ####### # ### ##### ####### ##### # ######### # ### # # ### # # # # # ### # # # ### ####### # # ### ##### # # # ##### # # # # ### # ### # # ### # # ### ####### # # # # # ### # # # ####### ### # ##### # # #
#   #   #   #   # #   #     # #       #   #   # #     #     #         #   #     # #   # #     #   # #   #   #   # #   #       #   #     #   #   #   # # #   #       # #   #         # # # # # #   # # #         # # #         # #
### ####### # # # ### ##### # # ##### ##### # ### ##### ### # ################### ##### ####### ### # ### # # ### ### ####### ######### # ######### # # # ########### # # ########### # # # ### ### # ########### # ########### #
# # #       # # #   #   #   # # #   #   #   # #   #   #   # # #       #     #       #         #   # # #   #     # #   #     # #         #     #     # # # #   #       # #   #   #     #   #   # #   # # #         # #     #     #
# # # ####### # ### ### # # # # # ##### # ### # ### # ### # ### ##### # # ### # ### # ########### # ### ####### # # ### ##### ##### ######### # ##### # # # # # ####### ### # # # ########### # # ### # # # ##### # # ### # ### #
#   #   #     #   #   # # # #   #       #   #   #   # #   # #   #   #   #   # #   #   #         # # #   #   #     # #   #     #   #     #   #   #   #   # # # # #     # # #   #   #   #     #   # #   # # # #     #   # # #   # #
# ### # # ##### # ### # # ####### ####### # ##### # ### ### # ### # ####### # ### # ### ####### # # # ### # ####### # ### ##### # ##### ### ##### ####### # # # # # ### # ######### # # # # ####### ### # # ### ####### # # # # #
# #   #       # # # # #   #     #       # #     # # #   # #   #   #   #   # #   # # #   #     #   #     # #   #   # #     #     # #   #   # #           #   # # # #     #           #   # # #       #   # #   # #       # # # # #
# ########### # # # # ##### ### ####### # ##### ### # ### ######### # ### # # ### # # ####### ########### ### # # # # ##### ##### # # ### # # ######### ##### # ### ################### # # ##### ### ### ### ### ##### # # # ###
#   #     #   # # # # #   #   #       # # #   # #   # #       #     #   # # # #   # # #     #             # # # # # #     #   # #   #     #   #       #     # #   #   #     #   #     # # #     # # #   # # # #   #   #   # #   #
### # ### ##### # # # # # ### ### ##### ### # # # ### # ##### # ####### # # # # ##### ### # ####### ####### # # # # ##### ### # ########### ######### ##### # ### ### ### # # # # ### ### ##### # # # # # # # # ##### #########E#
#     #         #   #   #       #           #   #       #       #         #   #           #         #           #   #         #                           #       #       #   #   #       #       #   #     #                   #