#######
#S #  #
#  #E #
###   #
#######
