#############################################
#S    #     #   #       #       #     #     #
### # ### ### # ##### ### ### ### ### # ### #
#   #   #     #     #     #   #     # #   # #
# ##### ### ####### ##### ##### ### ### ### #
#     #   #       #     #     #   #     #   #
##### ### ####### ### ####### ### ##### ### #
#     #     #     # #     #   #     #   #   #
# ### ##### # ##### # ### # ####### ### ### #
#   #     # #     #   #   #     #   #   #   #
# # ### # # ### ####### ##### ### ### ##### #
# #   # # #   #       #     # #     #   #   #
# ### # # ### ####### ##### # # ### ### ### #
#     #   #   #       #   # #   #   #     # #
### ####### ### ##### # # ##### ### ##### # #
#   #     #     #   # # #     # #   #   # # #
# ### ### ##### ### # ##### ### # ### ### # #
#   #   #   #     # #     #   # #   #     # #
### ### ### ####### ### ### # # ### ####### #
#     #     #       #   #   # #     #     # #
# ##### ### # ##### ### ### ##### ### ### # #
#     #   #   #   #     #     #     #   #  E#
#############################################