###########
#S  T#    #
# ### ### #
#   #   #E#
# ###T## ##
#         #
###########
