#######
#S# #E#
# # # #
# ### #
#######
